geoid,name,totpop,totpop_e,owner,owner_e,renter,renter_e
14000US42101000101,"Census Tract 1.01, Philadelphia, PA",2004,313,539,213,1465,279
14000US42101000102,"Census Tract 1.02, Philadelphia, PA",2722,531,1100,342,1622,406
14000US42101000200,"Census Tract 2, Philadelphia, PA",3218,591,1701,639,1517,360
14000US42101000300,"Census Tract 3, Philadelphia, PA",3261,436,956,234,2305,388
14000US42101000401,"Census Tract 4.01, Philadelphia, PA",2526,432,945,302,1581,334
14000US42101000403,"Census Tract 4.03, Philadelphia, PA",965,336,654,338,311,119
14000US42101000404,"Census Tract 4.04, Philadelphia, PA",3260,346,1395,262,1865,346
14000US42101000500,"Census Tract 5, Philadelphia, PA",1568,194,114,78,1454,185
14000US42101000600,"Census Tract 6, Philadelphia, PA",1437,233,21,23,1416,237
14000US42101000701,"Census Tract 7.01, Philadelphia, PA",1666,363,434,169,1232,353
14000US42101000702,"Census Tract 7.02, Philadelphia, PA",2181,564,407,159,1774,535
14000US42101000801,"Census Tract 8.01, Philadelphia, PA",1670,350,600,176,1070,336
14000US42101000803,"Census Tract 8.03, Philadelphia, PA",2911,475,1268,312,1643,401
14000US42101000805,"Census Tract 8.05, Philadelphia, PA",2532,443,631,229,1901,444
14000US42101000806,"Census Tract 8.06, Philadelphia, PA",2227,364,649,184,1578,385
14000US42101000901,"Census Tract 9.01, Philadelphia, PA",2073,304,181,102,1892,299
14000US42101000902,"Census Tract 9.02, Philadelphia, PA",2290,396,475,179,1815,387
14000US42101001001,"Census Tract 10.01, Philadelphia, PA",2809,444,1752,270,1057,411
14000US42101001002,"Census Tract 10.02, Philadelphia, PA",3644,429,2723,448,921,220
14000US42101001101,"Census Tract 11.01, Philadelphia, PA",3754,718,921,281,2833,730
14000US42101001102,"Census Tract 11.02, Philadelphia, PA",2653,424,1603,430,1050,216
14000US42101001201,"Census Tract 12.01, Philadelphia, PA",4220,776,2080,430,2140,702
14000US42101001203,"Census Tract 12.03, Philadelphia, PA",1965,307,706,251,1259,206
14000US42101001204,"Census Tract 12.04, Philadelphia, PA",2706,337,937,228,1769,333
14000US42101001301,"Census Tract 13.01, Philadelphia, PA",1924,592,1470,596,454,123
14000US42101001302,"Census Tract 13.02, Philadelphia, PA",5086,1078,2937,1087,2149,499
14000US42101001400,"Census Tract 14, Philadelphia, PA",4140,738,2476,734,1664,332
14000US42101001500,"Census Tract 15, Philadelphia, PA",3152,678,2198,730,954,242
14000US42101001600,"Census Tract 16, Philadelphia, PA",2349,426,1346,301,1003,364
14000US42101001700,"Census Tract 17, Philadelphia, PA",3021,585,2162,574,859,192
14000US42101001800,"Census Tract 18, Philadelphia, PA",3299,329,1945,296,1354,276
14000US42101001900,"Census Tract 19, Philadelphia, PA",4026,535,2412,463,1614,380
14000US42101002000,"Census Tract 20, Philadelphia, PA",2004,261,1347,221,657,218
14000US42101002100,"Census Tract 21, Philadelphia, PA",2381,354,1527,350,854,207
14000US42101002200,"Census Tract 22, Philadelphia, PA",2355,401,1122,373,1233,261
14000US42101002300,"Census Tract 23, Philadelphia, PA",2972,463,1625,382,1347,450
14000US42101002400,"Census Tract 24, Philadelphia, PA",4860,588,2800,508,2060,459
14000US42101002500,"Census Tract 25, Philadelphia, PA",4393,588,2525,448,1868,455
14000US42101002701,"Census Tract 27.01, Philadelphia, PA",3890,516,2353,476,1537,365
14000US42101002702,"Census Tract 27.02, Philadelphia, PA",4475,613,3169,465,1306,465
14000US42101002801,"Census Tract 28.01, Philadelphia, PA",4500,783,1762,483,2738,879
14000US42101002802,"Census Tract 28.02, Philadelphia, PA",5491,789,3392,618,2099,784
14000US42101002900,"Census Tract 29, Philadelphia, PA",4096,544,2856,399,1240,459
14000US42101003001,"Census Tract 30.01, Philadelphia, PA",3414,404,2152,408,1262,370
14000US42101003002,"Census Tract 30.02, Philadelphia, PA",3124,434,1826,388,1298,257
14000US42101003100,"Census Tract 31, Philadelphia, PA",5220,1138,2967,1065,2253,836
14000US42101003200,"Census Tract 32, Philadelphia, PA",3946,523,2122,475,1824,550
14000US42101003300,"Census Tract 33, Philadelphia, PA",6303,1074,2149,847,4154,1087
14000US42101003600,"Census Tract 36, Philadelphia, PA",6918,1472,3717,1174,3201,1088
14000US42101003701,"Census Tract 37.01, Philadelphia, PA",6004,984,4012,1082,1992,784
14000US42101003702,"Census Tract 37.02, Philadelphia, PA",3867,883,1729,569,2138,868
14000US42101003800,"Census Tract 38, Philadelphia, PA",3906,673,3228,644,678,282
14000US42101003901,"Census Tract 39.01, Philadelphia, PA",6373,684,3293,704,3080,671
14000US42101003902,"Census Tract 39.02, Philadelphia, PA",5569,712,4019,615,1550,630
14000US42101004001,"Census Tract 40.01, Philadelphia, PA",4103,519,2137,504,1966,513
14000US42101004002,"Census Tract 40.02, Philadelphia, PA",5199,959,3956,973,1243,727
14000US42101004101,"Census Tract 41.01, Philadelphia, PA",5020,803,3080,533,1940,766
14000US42101004103,"Census Tract 41.03, Philadelphia, PA",4751,1706,1970,863,2781,1579
14000US42101004104,"Census Tract 41.04, Philadelphia, PA",4143,856,1891,458,2252,883
14000US42101004201,"Census Tract 42.01, Philadelphia, PA",4985,673,4046,759,939,399
14000US42101004202,"Census Tract 42.02, Philadelphia, PA",5434,866,4120,751,1314,610
14000US42101005400,"Census Tract 54, Philadelphia, PA",1568,271,589,216,979,250
14000US42101005500,"Census Tract 55, Philadelphia, PA",6519,989,4229,644,2290,818
14000US42101005600,"Census Tract 56, Philadelphia, PA",1170,271,132,67,1038,271
14000US42101006000,"Census Tract 60, Philadelphia, PA",6230,932,3855,921,2375,846
14000US42101006100,"Census Tract 61, Philadelphia, PA",2779,519,2070,403,709,343
14000US42101006200,"Census Tract 62, Philadelphia, PA",4252,672,1872,566,2380,629
14000US42101006300,"Census Tract 63, Philadelphia, PA",3696,739,945,280,2751,743
14000US42101006400,"Census Tract 64, Philadelphia, PA",4711,914,2774,795,1937,729
14000US42101006500,"Census Tract 65, Philadelphia, PA",4270,943,2463,596,1807,864
14000US42101006600,"Census Tract 66, Philadelphia, PA",3523,970,1189,454,2334,950
14000US42101006700,"Census Tract 67, Philadelphia, PA",7875,1341,3210,1075,4665,1407
14000US42101007000,"Census Tract 70, Philadelphia, PA",3620,950,1702,381,1918,946
14000US42101007101,"Census Tract 71.01, Philadelphia, PA",2518,439,1028,246,1490,471
14000US42101007102,"Census Tract 71.02, Philadelphia, PA",4436,685,2084,538,2352,641
14000US42101007200,"Census Tract 72, Philadelphia, PA",4445,925,2048,671,2397,944
14000US42101007300,"Census Tract 73, Philadelphia, PA",3173,607,1471,476,1702,607
14000US42101007400,"Census Tract 74, Philadelphia, PA",4505,859,1827,418,2678,923
14000US42101007700,"Census Tract 77, Philadelphia, PA",1316,206,262,76,1054,215
14000US42101007800,"Census Tract 78, Philadelphia, PA",4029,517,1310,374,2719,475
14000US42101007900,"Census Tract 79, Philadelphia, PA",4314,615,2418,644,1896,296
14000US42101008000,"Census Tract 80, Philadelphia, PA",4019,795,1924,489,2095,803
14000US42101008101,"Census Tract 81.01, Philadelphia, PA",3320,594,1478,636,1842,461
14000US42101008102,"Census Tract 81.02, Philadelphia, PA",4636,901,3391,1011,1245,442
14000US42101008200,"Census Tract 82, Philadelphia, PA",6906,1315,4249,987,2657,1323
14000US42101008301,"Census Tract 83.01, Philadelphia, PA",4072,888,2131,762,1941,899
14000US42101008302,"Census Tract 83.02, Philadelphia, PA",4556,706,1853,505,2703,668
14000US42101008400,"Census Tract 84, Philadelphia, PA",5045,1007,3079,1070,1966,455
14000US42101008500,"Census Tract 85, Philadelphia, PA",6199,859,2555,632,3644,877
14000US42101008601,"Census Tract 86.01, Philadelphia, PA",3536,563,932,458,2604,577
14000US42101008602,"Census Tract 86.02, Philadelphia, PA",3068,572,463,187,2605,627
14000US42101008701,"Census Tract 87.01, Philadelphia, PA",3178,411,713,267,2465,480
14000US42101008702,"Census Tract 87.02, Philadelphia, PA",2531,435,463,172,2068,441
14000US42101008801,"Census Tract 88.01, Philadelphia, PA",626,262,0,11,626,262
14000US42101008802,"Census Tract 88.02, Philadelphia, PA",3095,823,128,158,2967,802
14000US42101009000,"Census Tract 90, Philadelphia, PA",2766,587,232,80,2534,553
14000US42101009100,"Census Tract 91, Philadelphia, PA",2746,345,672,178,2074,319
14000US42101009200,"Census Tract 92, Philadelphia, PA",3483,573,1437,364,2046,482
14000US42101009300,"Census Tract 93, Philadelphia, PA",5171,645,3060,718,2111,515
14000US42101009400,"Census Tract 94, Philadelphia, PA",3891,581,991,233,2900,606
14000US42101009500,"Census Tract 95, Philadelphia, PA",3436,655,1156,382,2280,554
14000US42101009600,"Census Tract 96, Philadelphia, PA",3775,638,1731,438,2044,662
14000US42101009801,"Census Tract 98.01, Philadelphia, PA",2455,640,1706,572,749,272
14000US42101009802,"Census Tract 98.02, Philadelphia, PA",5707,990,4391,1206,1316,568
14000US42101010000,"Census Tract 100, Philadelphia, PA",5041,747,3342,721,1699,654
14000US42101010100,"Census Tract 101, Philadelphia, PA",5531,1197,3159,840,2372,1318
14000US42101010200,"Census Tract 102, Philadelphia, PA",3507,659,1450,692,2057,494
14000US42101010300,"Census Tract 103, Philadelphia, PA",2757,655,829,385,1928,686
14000US42101010400,"Census Tract 104, Philadelphia, PA",3365,823,1095,377,2270,891
14000US42101010500,"Census Tract 105, Philadelphia, PA",3425,609,1384,383,2041,600
14000US42101010600,"Census Tract 106, Philadelphia, PA",1608,376,468,266,1140,450
14000US42101010700,"Census Tract 107, Philadelphia, PA",3466,892,1562,435,1904,879
14000US42101010800,"Census Tract 108, Philadelphia, PA",4358,789,988,300,3370,782
14000US42101010900,"Census Tract 109, Philadelphia, PA",2722,388,573,231,2149,391
14000US42101011000,"Census Tract 110, Philadelphia, PA",2853,802,1048,395,1805,773
14000US42101011100,"Census Tract 111, Philadelphia, PA",3815,704,2615,717,1200,520
14000US42101011200,"Census Tract 112, Philadelphia, PA",6434,1359,2971,842,3463,1381
14000US42101011300,"Census Tract 113, Philadelphia, PA",3533,706,2216,523,1317,598
14000US42101011400,"Census Tract 114, Philadelphia, PA",6388,1139,3994,1054,2394,725
14000US42101011500,"Census Tract 115, Philadelphia, PA",4606,717,3643,771,963,435
14000US42101011700,"Census Tract 117, Philadelphia, PA",938,236,775,231,163,75
14000US42101011800,"Census Tract 118, Philadelphia, PA",5583,941,5110,1011,473,277
14000US42101011900,"Census Tract 119, Philadelphia, PA",5113,1124,3372,1265,1741,513
14000US42101012000,"Census Tract 120, Philadelphia, PA",1611,367,936,328,675,232
14000US42101012100,"Census Tract 121, Philadelphia, PA",2852,454,1069,201,1783,438
14000US42101012201,"Census Tract 122.01, Philadelphia, PA",2828,521,0,11,2828,521
14000US42101012203,"Census Tract 122.03, Philadelphia, PA",855,233,0,11,855,233
14000US42101012204,"Census Tract 122.04, Philadelphia, PA",3486,439,1801,384,1685,401
14000US42101012501,"Census Tract 125.01, Philadelphia, PA",1589,443,0,11,1589,443
14000US42101012502,"Census Tract 125.02, Philadelphia, PA",3697,476,714,285,2983,393
14000US42101013100,"Census Tract 131, Philadelphia, PA",1656,307,291,108,1365,281
14000US42101013200,"Census Tract 132, Philadelphia, PA",2687,354,545,267,2142,386
14000US42101013300,"Census Tract 133, Philadelphia, PA",3146,501,738,187,2408,516
14000US42101013401,"Census Tract 134.01, Philadelphia, PA",2909,357,1794,262,1115,287
14000US42101013402,"Census Tract 134.02, Philadelphia, PA",2980,476,1078,283,1902,428
14000US42101013500,"Census Tract 135, Philadelphia, PA",4015,468,2747,547,1268,288
14000US42101013601,"Census Tract 136.01, Philadelphia, PA",2981,254,1855,293,1126,302
14000US42101013602,"Census Tract 136.02, Philadelphia, PA",4162,511,2180,339,1982,547
14000US42101013701,"Census Tract 137.01, Philadelphia, PA",1557,362,718,226,839,287
14000US42101013702,"Census Tract 137.02, Philadelphia, PA",3998,988,1738,810,2260,740
14000US42101013800,"Census Tract 138, Philadelphia, PA",1806,322,765,285,1041,249
14000US42101013900,"Census Tract 139, Philadelphia, PA",2513,909,1125,649,1388,678
14000US42101014000,"Census Tract 140, Philadelphia, PA",4470,945,787,362,3683,1013
14000US42101014100,"Census Tract 141, Philadelphia, PA",2553,568,735,322,1818,424
14000US42101014201,"Census Tract 142.01, Philadelphia, PA",3673,574,1719,571,1954,458
14000US42101014202,"Census Tract 142.02, Philadelphia, PA",2350,483,860,355,1490,411
14000US42101014300,"Census Tract 143, Philadelphia, PA",1970,230,1089,154,881,208
14000US42101014400,"Census Tract 144, Philadelphia, PA",5042,772,2717,615,2325,775
14000US42101014500,"Census Tract 145, Philadelphia, PA",2038,388,625,305,1413,370
14000US42101014600,"Census Tract 146, Philadelphia, PA",2612,465,979,207,1633,476
14000US42101014700,"Census Tract 147, Philadelphia, PA",2589,555,421,363,2168,431
14000US42101014800,"Census Tract 148, Philadelphia, PA",840,321,148,163,692,289
14000US42101014900,"Census Tract 149, Philadelphia, PA",4314,1085,1862,860,2452,862
14000US42101015101,"Census Tract 151.01, Philadelphia, PA",1993,453,697,275,1296,450
14000US42101015102,"Census Tract 151.02, Philadelphia, PA",5035,1411,1630,1136,3405,894
14000US42101015200,"Census Tract 152, Philadelphia, PA",5401,1423,1758,810,3643,1500
14000US42101015300,"Census Tract 153, Philadelphia, PA",3523,932,1115,907,2408,512
14000US42101015600,"Census Tract 156, Philadelphia, PA",1671,460,655,222,1016,438
14000US42101015700,"Census Tract 157, Philadelphia, PA",2340,430,1629,413,711,287
14000US42101015800,"Census Tract 158, Philadelphia, PA",7204,779,4893,916,2311,677
14000US42101016001,"Census Tract 160.01, Philadelphia, PA",2398,505,1763,343,635,431
14000US42101016002,"Census Tract 160.02, Philadelphia, PA",4504,815,2896,572,1608,608
14000US42101016100,"Census Tract 161, Philadelphia, PA",5883,659,3373,629,2510,561
14000US42101016200,"Census Tract 162, Philadelphia, PA",2447,633,1327,593,1120,401
14000US42101016300,"Census Tract 163, Philadelphia, PA",2632,595,965,560,1667,484
14000US42101016400,"Census Tract 164, Philadelphia, PA",4373,890,1630,508,2743,793
14000US42101016500,"Census Tract 165, Philadelphia, PA",3056,633,772,486,2284,604
14000US42101016600,"Census Tract 166, Philadelphia, PA",2010,639,667,430,1343,505
14000US42101016701,"Census Tract 167.01, Philadelphia, PA",3570,809,2000,704,1570,706
14000US42101016702,"Census Tract 167.02, Philadelphia, PA",2439,431,948,318,1491,490
14000US42101016800,"Census Tract 168, Philadelphia, PA",3417,1025,1399,421,2018,1110
14000US42101016901,"Census Tract 169.01, Philadelphia, PA",3189,1126,2029,1159,1160,582
14000US42101016902,"Census Tract 169.02, Philadelphia, PA",3275,882,1801,968,1474,611
14000US42101017000,"Census Tract 170, Philadelphia, PA",3024,582,693,258,2331,655
14000US42101017100,"Census Tract 171, Philadelphia, PA",3517,813,1905,526,1612,768
14000US42101017201,"Census Tract 172.01, Philadelphia, PA",3015,777,1767,649,1248,513
14000US42101017202,"Census Tract 172.02, Philadelphia, PA",4500,756,2710,682,1790,686
14000US42101017300,"Census Tract 173, Philadelphia, PA",2704,506,1308,542,1396,470
14000US42101017400,"Census Tract 174, Philadelphia, PA",2582,535,1275,495,1307,406
14000US42101017500,"Census Tract 175, Philadelphia, PA",6638,1311,3357,1080,3281,1481
14000US42101017601,"Census Tract 176.01, Philadelphia, PA",4619,883,2378,653,2241,858
14000US42101017602,"Census Tract 176.02, Philadelphia, PA",4029,826,1653,805,2376,769
14000US42101017701,"Census Tract 177.01, Philadelphia, PA",3401,904,1146,626,2255,801
14000US42101017702,"Census Tract 177.02, Philadelphia, PA",4706,797,2185,530,2521,671
14000US42101017800,"Census Tract 178, Philadelphia, PA",5818,1250,3327,1088,2491,960
14000US42101017900,"Census Tract 179, Philadelphia, PA",5742,1240,2907,1113,2835,1012
14000US42101018001,"Census Tract 180.01, Philadelphia, PA",2289,307,1424,351,865,289
14000US42101018002,"Census Tract 180.02, Philadelphia, PA",5982,1145,4862,1131,1120,379
14000US42101018300,"Census Tract 183, Philadelphia, PA",4037,695,3722,703,315,156
14000US42101018400,"Census Tract 184, Philadelphia, PA",2302,426,2074,399,228,170
14000US42101018801,"Census Tract 188.01, Philadelphia, PA",3383,836,1420,545,1963,734
14000US42101018802,"Census Tract 188.02, Philadelphia, PA",4108,1573,1017,893,3091,1865
14000US42101019000,"Census Tract 190, Philadelphia, PA",7750,1362,5704,1375,2046,767
14000US42101019100,"Census Tract 191, Philadelphia, PA",7997,1339,6228,1416,1769,682
14000US42101019200,"Census Tract 192, Philadelphia, PA",8634,1451,5121,1504,3513,1132
14000US42101019501,"Census Tract 195.01, Philadelphia, PA",4931,1123,1804,610,3127,1198
14000US42101019502,"Census Tract 195.02, Philadelphia, PA",3870,840,2269,767,1601,527
14000US42101019700,"Census Tract 197, Philadelphia, PA",6971,1215,2719,823,4252,1229
14000US42101019800,"Census Tract 198, Philadelphia, PA",6090,804,3522,876,2568,929
14000US42101019900,"Census Tract 199, Philadelphia, PA",5381,1268,1770,646,3611,1256
14000US42101020000,"Census Tract 200, Philadelphia, PA",1105,185,284,149,821,211
14000US42101020101,"Census Tract 201.01, Philadelphia, PA",3157,707,707,598,2450,571
14000US42101020102,"Census Tract 201.02, Philadelphia, PA",3741,785,2262,704,1479,757
14000US42101020200,"Census Tract 202, Philadelphia, PA",4279,914,2126,692,2153,719
14000US42101020300,"Census Tract 203, Philadelphia, PA",2853,597,1303,485,1550,398
14000US42101020400,"Census Tract 204, Philadelphia, PA",3433,618,2316,745,1117,630
14000US42101020500,"Census Tract 205, Philadelphia, PA",3111,1312,1215,412,1896,1289
14000US42101020600,"Census Tract 206, Philadelphia, PA",1648,252,735,231,913,170
14000US42101020701,"Census Tract 207.01, Philadelphia, PA",4160,490,2299,390,1861,518
14000US42101020702,"Census Tract 207.02, Philadelphia, PA",1308,228,922,254,386,196
14000US42101020800,"Census Tract 208, Philadelphia, PA",2156,409,717,231,1439,401
14000US42101020900,"Census Tract 209, Philadelphia, PA",3123,434,1435,336,1688,431
14000US42101021000,"Census Tract 210, Philadelphia, PA",5406,742,2455,820,2951,650
14000US42101021100,"Census Tract 211, Philadelphia, PA",2494,329,1692,324,802,215
14000US42101021200,"Census Tract 212, Philadelphia, PA",2640,506,1941,505,699,294
14000US42101021300,"Census Tract 213, Philadelphia, PA",3216,428,1663,371,1553,414
14000US42101021400,"Census Tract 214, Philadelphia, PA",3738,492,1533,283,2205,524
14000US42101021500,"Census Tract 215, Philadelphia, PA",3953,627,2130,346,1823,636
14000US42101021600,"Census Tract 216, Philadelphia, PA",2449,272,1181,192,1268,234
14000US42101021700,"Census Tract 217, Philadelphia, PA",6116,686,5116,520,1000,470
14000US42101021800,"Census Tract 218, Philadelphia, PA",5193,595,1793,412,3400,667
14000US42101021900,"Census Tract 219, Philadelphia, PA",1437,289,1263,282,174,108
14000US42101022000,"Census Tract 220, Philadelphia, PA",1364,238,978,125,386,233
14000US42101023100,"Census Tract 231, Philadelphia, PA",1293,202,931,215,362,136
14000US42101023500,"Census Tract 235, Philadelphia, PA",1294,253,1015,238,279,173
14000US42101023600,"Census Tract 236, Philadelphia, PA",2147,475,1667,464,480,197
14000US42101023700,"Census Tract 237, Philadelphia, PA",4627,1038,2527,537,2100,1018
14000US42101023800,"Census Tract 238, Philadelphia, PA",4749,1278,2821,1264,1928,566
14000US42101023900,"Census Tract 239, Philadelphia, PA",1800,385,339,176,1461,352
14000US42101024000,"Census Tract 240, Philadelphia, PA",4007,757,1927,671,2080,464
14000US42101024100,"Census Tract 241, Philadelphia, PA",1027,258,328,246,699,101
14000US42101024200,"Census Tract 242, Philadelphia, PA",4496,870,1892,555,2604,771
14000US42101024300,"Census Tract 243, Philadelphia, PA",4465,669,2525,699,1940,541
14000US42101024400,"Census Tract 244, Philadelphia, PA",3469,767,2139,790,1330,393
14000US42101024500,"Census Tract 245, Philadelphia, PA",4302,1179,1836,601,2466,1140
14000US42101024600,"Census Tract 246, Philadelphia, PA",2444,639,715,508,1729,662
14000US42101024700,"Census Tract 247, Philadelphia, PA",4310,716,2088,474,2222,662
14000US42101024800,"Census Tract 248, Philadelphia, PA",2350,459,1820,405,530,302
14000US42101024900,"Census Tract 249, Philadelphia, PA",2590,868,1588,791,1002,494
14000US42101025200,"Census Tract 252, Philadelphia, PA",7478,1059,3921,1072,3557,831
14000US42101025300,"Census Tract 253, Philadelphia, PA",4792,863,2751,645,2041,715
14000US42101025400,"Census Tract 254, Philadelphia, PA",4284,785,3211,724,1073,301
14000US42101025500,"Census Tract 255, Philadelphia, PA",2756,421,2222,414,534,207
14000US42101025600,"Census Tract 256, Philadelphia, PA",2703,412,2058,348,645,294
14000US42101025700,"Census Tract 257, Philadelphia, PA",3822,454,1258,414,2564,333
14000US42101025800,"Census Tract 258, Philadelphia, PA",1745,329,1424,376,321,179
14000US42101025900,"Census Tract 259, Philadelphia, PA",4414,1057,3700,1107,714,290
14000US42101026000,"Census Tract 260, Philadelphia, PA",3293,583,2536,649,757,289
14000US42101026100,"Census Tract 261, Philadelphia, PA",2880,844,2231,850,649,224
14000US42101026200,"Census Tract 262, Philadelphia, PA",3925,708,3216,685,709,397
14000US42101026301,"Census Tract 263.01, Philadelphia, PA",3668,805,3056,829,612,278
14000US42101026302,"Census Tract 263.02, Philadelphia, PA",4796,751,3679,711,1117,641
14000US42101026400,"Census Tract 264, Philadelphia, PA",5559,1167,3652,664,1907,1158
14000US42101026500,"Census Tract 265, Philadelphia, PA",5516,1137,4129,1185,1387,567
14000US42101026600,"Census Tract 266, Philadelphia, PA",6831,1084,5146,973,1685,811
14000US42101026700,"Census Tract 267, Philadelphia, PA",7692,1375,5702,1304,1990,794
14000US42101026800,"Census Tract 268, Philadelphia, PA",4239,569,1758,511,2481,479
14000US42101026900,"Census Tract 269, Philadelphia, PA",2156,373,1784,334,372,141
14000US42101027000,"Census Tract 270, Philadelphia, PA",2597,440,2111,477,486,109
14000US42101027100,"Census Tract 271, Philadelphia, PA",2519,385,1793,387,726,289
14000US42101027200,"Census Tract 272, Philadelphia, PA",4510,635,3384,644,1126,323
14000US42101027300,"Census Tract 273, Philadelphia, PA",5749,967,3581,748,2168,851
14000US42101027401,"Census Tract 274.01, Philadelphia, PA",2732,512,1261,374,1471,534
14000US42101027402,"Census Tract 274.02, Philadelphia, PA",7402,1153,5618,1295,1784,1261
14000US42101027500,"Census Tract 275, Philadelphia, PA",4908,835,3557,866,1351,497
14000US42101027600,"Census Tract 276, Philadelphia, PA",4248,812,2492,733,1756,523
14000US42101027700,"Census Tract 277, Philadelphia, PA",5167,1052,3466,984,1701,619
14000US42101027800,"Census Tract 278, Philadelphia, PA",4841,787,2087,589,2754,822
14000US42101027901,"Census Tract 279.01, Philadelphia, PA",3758,641,1877,516,1881,529
14000US42101027902,"Census Tract 279.02, Philadelphia, PA",3075,903,1000,305,2075,867
14000US42101028000,"Census Tract 280, Philadelphia, PA",4283,928,2807,969,1476,488
14000US42101028100,"Census Tract 281, Philadelphia, PA",4253,846,3077,637,1176,521
14000US42101028200,"Census Tract 282, Philadelphia, PA",4757,1068,3249,896,1508,635
14000US42101028300,"Census Tract 283, Philadelphia, PA",6658,1521,2925,750,3733,1515
14000US42101028400,"Census Tract 284, Philadelphia, PA",3742,671,1918,412,1824,629
14000US42101028500,"Census Tract 285, Philadelphia, PA",2735,584,1301,574,1434,371
14000US42101028600,"Census Tract 286, Philadelphia, PA",7253,1104,3957,967,3296,1209
14000US42101028700,"Census Tract 287, Philadelphia, PA",2688,920,1018,313,1670,856
14000US42101028800,"Census Tract 288, Philadelphia, PA",5204,1101,3534,1044,1670,729
14000US42101028901,"Census Tract 289.01, Philadelphia, PA",4437,995,2558,735,1879,899
14000US42101028902,"Census Tract 289.02, Philadelphia, PA",6739,1289,4866,1166,1873,778
14000US42101029000,"Census Tract 290, Philadelphia, PA",9047,1729,5288,1781,3759,1629
14000US42101029100,"Census Tract 291, Philadelphia, PA",4282,652,1353,356,2929,737
14000US42101029200,"Census Tract 292, Philadelphia, PA",4299,706,3983,742,316,159
14000US42101029300,"Census Tract 293, Philadelphia, PA",2996,606,1488,639,1508,511
14000US42101029400,"Census Tract 294, Philadelphia, PA",4111,890,1598,540,2513,937
14000US42101029800,"Census Tract 298, Philadelphia, PA",5192,775,3023,696,2169,686
14000US42101029900,"Census Tract 299, Philadelphia, PA",4358,824,1776,713,2582,567
14000US42101030000,"Census Tract 300, Philadelphia, PA",7925,1233,3499,1571,4426,1562
14000US42101030100,"Census Tract 301, Philadelphia, PA",5582,1042,3500,895,2082,708
14000US42101030200,"Census Tract 302, Philadelphia, PA",8668,1213,6360,1158,2308,1010
14000US42101030501,"Census Tract 305.01, Philadelphia, PA",5099,762,2908,544,2191,729
14000US42101030502,"Census Tract 305.02, Philadelphia, PA",7460,2165,5499,2182,1961,650
14000US42101030600,"Census Tract 306, Philadelphia, PA",6875,851,5135,880,1740,627
14000US42101030700,"Census Tract 307, Philadelphia, PA",4552,725,1818,431,2734,684
14000US42101030800,"Census Tract 308, Philadelphia, PA",5438,857,3885,928,1553,651
14000US42101030900,"Census Tract 309, Philadelphia, PA",4425,788,2003,380,2422,826
14000US42101031000,"Census Tract 310, Philadelphia, PA",8124,1577,3996,880,4128,1468
14000US42101031101,"Census Tract 311.01, Philadelphia, PA",4743,794,2438,579,2305,756
14000US42101031102,"Census Tract 311.02, Philadelphia, PA",4560,1093,2277,415,2283,1182
14000US42101031200,"Census Tract 312, Philadelphia, PA",5319,798,2813,924,2506,830
14000US42101031300,"Census Tract 313, Philadelphia, PA",7688,969,3233,833,4455,1164
14000US42101031401,"Census Tract 314.01, Philadelphia, PA",7962,1785,2421,732,5541,1773
14000US42101031402,"Census Tract 314.02, Philadelphia, PA",6421,771,3271,665,3150,614
14000US42101031501,"Census Tract 315.01, Philadelphia, PA",7359,1320,5023,1136,2336,1204
14000US42101031502,"Census Tract 315.02, Philadelphia, PA",3732,504,2287,462,1445,577
14000US42101031600,"Census Tract 316, Philadelphia, PA",6734,1511,3534,791,3200,1600
14000US42101031700,"Census Tract 317, Philadelphia, PA",5855,1022,4113,1028,1742,798
14000US42101031800,"Census Tract 318, Philadelphia, PA",4295,918,2765,648,1530,770
14000US42101031900,"Census Tract 319, Philadelphia, PA",5504,1000,3380,728,2124,999
14000US42101032000,"Census Tract 320, Philadelphia, PA",8523,1947,4385,838,4138,1988
14000US42101032100,"Census Tract 321, Philadelphia, PA",3703,597,1435,550,2268,507
14000US42101032300,"Census Tract 323, Philadelphia, PA",3647,629,2101,597,1546,674
14000US42101032500,"Census Tract 325, Philadelphia, PA",6054,931,3550,800,2504,1053
14000US42101032600,"Census Tract 326, Philadelphia, PA",7986,861,6137,995,1849,893
14000US42101032900,"Census Tract 329, Philadelphia, PA",3675,538,1957,496,1718,384
14000US42101033000,"Census Tract 330, Philadelphia, PA",10051,1521,5109,1243,4942,1815
14000US42101033101,"Census Tract 331.01, Philadelphia, PA",5458,1023,4413,1075,1045,413
14000US42101033102,"Census Tract 331.02, Philadelphia, PA",3800,604,2067,470,1733,693
14000US42101033200,"Census Tract 332, Philadelphia, PA",3088,512,2175,458,913,423
14000US42101033300,"Census Tract 333, Philadelphia, PA",3246,457,2244,473,1002,264
14000US42101033400,"Census Tract 334, Philadelphia, PA",5415,798,3281,496,2134,785
14000US42101033500,"Census Tract 335, Philadelphia, PA",4021,777,1698,411,2323,781
14000US42101033600,"Census Tract 336, Philadelphia, PA",6405,815,3707,854,2698,550
14000US42101033701,"Census Tract 337.01, Philadelphia, PA",7187,1687,2686,595,4501,1716
14000US42101033702,"Census Tract 337.02, Philadelphia, PA",4524,526,3571,504,953,415
14000US42101033800,"Census Tract 338, Philadelphia, PA",6889,805,4717,783,2172,589
14000US42101033900,"Census Tract 339, Philadelphia, PA",2962,434,1820,264,1142,425
14000US42101034000,"Census Tract 340, Philadelphia, PA",2937,418,2630,390,307,213
14000US42101034100,"Census Tract 341, Philadelphia, PA",5590,873,3472,742,2118,607
14000US42101034200,"Census Tract 342, Philadelphia, PA",3533,367,1748,262,1785,361
14000US42101034400,"Census Tract 344, Philadelphia, PA",7726,884,7218,877,508,227
14000US42101034501,"Census Tract 345.01, Philadelphia, PA",5049,940,1030,423,4019,887
14000US42101034502,"Census Tract 345.02, Philadelphia, PA",5639,695,2455,567,3184,659
14000US42101034600,"Census Tract 346, Philadelphia, PA",2573,504,658,326,1915,419
14000US42101034701,"Census Tract 347.01, Philadelphia, PA",7151,1373,4801,893,2350,1211
14000US42101034702,"Census Tract 347.02, Philadelphia, PA",3531,294,3156,277,375,192
14000US42101034801,"Census Tract 348.01, Philadelphia, PA",4787,533,2665,488,2122,492
14000US42101034802,"Census Tract 348.02, Philadelphia, PA",5664,982,3598,960,2066,658
14000US42101034803,"Census Tract 348.03, Philadelphia, PA",3842,407,3501,394,341,127
14000US42101034900,"Census Tract 349, Philadelphia, PA",5619,770,3899,579,1720,584
14000US42101035100,"Census Tract 351, Philadelphia, PA",3740,611,2570,579,1170,424
14000US42101035200,"Census Tract 352, Philadelphia, PA",4708,547,4192,534,516,264
14000US42101035301,"Census Tract 353.01, Philadelphia, PA",5419,617,4212,440,1207,539
14000US42101035302,"Census Tract 353.02, Philadelphia, PA",4581,1108,3430,1098,1151,386
14000US42101035500,"Census Tract 355, Philadelphia, PA",7720,1221,5614,1262,2106,539
14000US42101035601,"Census Tract 356.01, Philadelphia, PA",5287,903,4280,923,1007,309
14000US42101035602,"Census Tract 356.02, Philadelphia, PA",3585,441,3172,444,413,175
14000US42101035701,"Census Tract 357.01, Philadelphia, PA",4641,539,1537,440,3104,439
14000US42101035702,"Census Tract 357.02, Philadelphia, PA",4255,733,1426,414,2829,732
14000US42101035800,"Census Tract 358, Philadelphia, PA",6464,1064,4799,745,1665,937
14000US42101035900,"Census Tract 359, Philadelphia, PA",5159,783,3861,688,1298,432
14000US42101036000,"Census Tract 360, Philadelphia, PA",3104,395,2192,416,912,271
14000US42101036100,"Census Tract 361, Philadelphia, PA",4051,624,2127,374,1924,658
14000US42101036201,"Census Tract 362.01, Philadelphia, PA",5300,1425,4049,1418,1251,385
14000US42101036202,"Census Tract 362.02, Philadelphia, PA",6091,896,5163,905,928,449
14000US42101036203,"Census Tract 362.03, Philadelphia, PA",4842,476,4429,500,413,198
14000US42101036301,"Census Tract 363.01, Philadelphia, PA",4149,736,3210,640,939,397
14000US42101036302,"Census Tract 363.02, Philadelphia, PA",3739,708,2513,699,1226,657
14000US42101036303,"Census Tract 363.03, Philadelphia, PA",6876,1162,6529,1111,347,317
14000US42101036400,"Census Tract 364, Philadelphia, PA",587,170,542,164,45,49
14000US42101036501,"Census Tract 365.01, Philadelphia, PA",4644,509,2613,538,2031,518
14000US42101036502,"Census Tract 365.02, Philadelphia, PA",4219,619,3646,521,573,359
14000US42101036600,"Census Tract 366, Philadelphia, PA",2305,369,1141,204,1164,374
14000US42101036700,"Census Tract 367, Philadelphia, PA",3405,537,1980,503,1425,410
14000US42101036901,"Census Tract 369.01, Philadelphia, PA",0,11,0,11,0,11
14000US42101036902,"Census Tract 369.02, Philadelphia, PA",1764,250,0,16,1764,250
14000US42101037200,"Census Tract 372, Philadelphia, PA",3948,656,2682,405,1266,559
14000US42101037300,"Census Tract 373, Philadelphia, PA",5864,751,4016,717,1848,444
14000US42101037500,"Census Tract 375, Philadelphia, PA",3067,418,1910,408,1157,267
14000US42101037600,"Census Tract 376, Philadelphia, PA",3015,386,933,325,2082,315
14000US42101037700,"Census Tract 377, Philadelphia, PA",3493,569,572,308,2921,625
14000US42101037800,"Census Tract 378, Philadelphia, PA",2247,428,1337,371,910,313
14000US42101037900,"Census Tract 379, Philadelphia, PA",4743,583,3395,607,1348,581
14000US42101038000,"Census Tract 380, Philadelphia, PA",2407,534,1618,515,789,293
14000US42101038100,"Census Tract 381, Philadelphia, PA",843,219,366,116,477,210
14000US42101038200,"Census Tract 382, Philadelphia, PA",3150,539,1819,476,1331,478
14000US42101038301,"Census Tract 383.01, Philadelphia, PA",1980,417,766,329,1214,475
14000US42101038400,"Census Tract 384, Philadelphia, PA",2393,230,2026,229,367,105
14000US42101038500,"Census Tract 385, Philadelphia, PA",1710,193,1265,192,445,99
14000US42101038600,"Census Tract 386, Philadelphia, PA",1437,253,1235,258,202,54
14000US42101038700,"Census Tract 387, Philadelphia, PA",1797,274,1312,193,485,224
14000US42101038800,"Census Tract 388, Philadelphia, PA",3691,656,2660,658,1031,296
14000US42101038900,"Census Tract 389, Philadelphia, PA",3274,587,1895,492,1379,446
14000US42101039001,"Census Tract 390.01, Philadelphia, PA",4045,683,2270,774,1775,822
14000US42101039002,"Census Tract 390.02, Philadelphia, PA",4272,1127,3917,1148,355,329
14000US42101039100,"Census Tract 391, Philadelphia, PA",3536,627,362,176,3174,637
14000US42101980001,"Census Tract 9800.01, Philadelphia, PA",0,11,0,11,0,11
14000US42101980002,"Census Tract 9800.02, Philadelphia, PA",0,11,0,11,0,11
14000US42101980003,"Census Tract 9800.03, Philadelphia, PA",0,11,0,11,0,11
14000US42101980100,"Census Tract 9801, Philadelphia, PA",296,417,289,417,7,11
14000US42101980200,"Census Tract 9802, Philadelphia, PA",43,47,43,47,0,11
14000US42101980300,"Census Tract 9803, Philadelphia, PA",0,11,0,11,0,11
14000US42101980400,"Census Tract 9804, Philadelphia, PA",0,11,0,11,0,11
14000US42101980500,"Census Tract 9805, Philadelphia, PA",0,11,0,11,0,11
14000US42101980600,"Census Tract 9806, Philadelphia, PA",0,11,0,11,0,11
14000US42101980701,"Census Tract 9807.01, Philadelphia, PA",0,11,0,11,0,11
14000US42101980702,"Census Tract 9807.02, Philadelphia, PA",0,11,0,11,0,11
14000US42101980800,"Census Tract 9808, Philadelphia, PA",0,11,0,11,0,11
14000US42101980901,"Census Tract 9809.01, Philadelphia, PA",0,11,0,11,0,11
14000US42101980902,"Census Tract 9809.02, Philadelphia, PA",0,11,0,11,0,11
14000US42101980903,"Census Tract 9809.03, Philadelphia, PA",0,11,0,11,0,11
14000US42101980904,"Census Tract 9809.04, Philadelphia, PA",0,11,0,11,0,11
14000US42101980905,"Census Tract 9809.05, Philadelphia, PA",0,11,0,11,0,11
14000US42101980906,"Census Tract 9809.06, Philadelphia, PA",0,11,0,11,0,11
14000US42101989100,"Census Tract 9891, Philadelphia, PA",0,11,0,11,0,11
14000US42101989200,"Census Tract 9892, Philadelphia, PA",0,11,0,11,0,11
14000US42101989300,"Census Tract 9893, Philadelphia, PA",0,11,0,11,0,11